1111100000000000000
1111100000000000000
1111100000000000000
1000000000000000000
1000000000000000000
1000333333300000000
1000000000000000000
1000000000000000000
1000000000000000000
1000000000000000000
1000000000000000000
1000000000000000000
1000000000000000000
1000000000000000000
1000000000000000000
